1 2 3 4 5 6 7 8 9 
9 8 7 6 5 4 3 2 1 
3 7 4 2 6 4 2 1 7
9 3 5 8 2 9 4 9 1 
9 3 0 1 8 3 8 4 8 
1 8 2 7 4 9 1 9 3 
3 7 4 2 6 4 2 1 7
9 3 5 8 2 9 4 9 1 
9 3 0 1 8 3 8 4 8